0700000000000000000040000000000000000000000000000000000000000000000000000000000000000000000000000008
0500055000000550500020000000000005500550005505057770000000000000000000000550500000000000000000800008
0000000000000000000550007770000000055000055000055550055055005500055000000000000055005000555888888008
0000000400000000000000005500000000000000000550000000077000000005500077777000088000000000000000000000
0000000200000000000000550000000000000000000000550055055000505550000000000000000000555500000000000008
0000033300000000000055000000000777777000000000005500000000000770000000000000000000777777000000000008
7770000000005500000000500550000000000033000000055000000055005550000000000088900077777777777000000008
3330000808000000550000000000000888000000000005500055500000000000550000005500000000000000000000000008
0000008808800330000000040040000000055000000550000000000000000008900900000000000000000000000000000008
0000088808880000000000027720000000005990000000000088009909008888009900330033000000000000000000000608
3333333333330333033303333333330333333333000333333333333333333333333333333333333330333333333033033333
3333333333333333333303000000000333333333303333333333333333333333333333333333333330333333333033033333