0000000000000000000007700000000000000000000000000000000000000000000000000000000000000000000000000005
0000000000000000000005500000000000777700000777777000000000007777777777000000007755555550000000000005
0000000000000000007777700000000000555500000500550000000000000777777770555555555500000000000000000005
0000000000077770000000005500000000000550000000000000000000000077777700000000000000000000005550000005
0000000000077777700000000000000000000000055550009990777000000007777055555000099900000000000000000005
0000000000055055000000500550000000000000000000000009999000005550055500000000000000099999990000000005
0000000000000000000000000000000000000000000000000000000000000000000000999990000099900000000000000005
0000000000055005500000000000077777770000000000000000000099908888000000000009999900000000000000000005
0000004040004040000000000008000000000000000000000000999000009999999999000000000000000000000000000005
0077702020002020000008000088000000000000999009990099000000000000000000777777777700000550000000000005
9999999999999999990990990099999990009999000000000000008888880000020000000000000000000440077777777775
9999999999999999990990990099990000000000777777777700008800008888888888000000000000088888888888888888